*a*
advance=avance 
amendment=avenant 
arbitrage=arbitrage 
absolute=absolu
acquire=acquérir
advice=conseil

*b*
bank=banque 
bless=benir
boat=bateau
broad=large

*c*
charm=charme
chick=poussin
computer=ordinateur

*d*
day=jour
define=définir
drink=boisson

*e*
ear=oreille
earn=gagner
enable=permettre

*f*
fly=voler
follow=suivre
forest=forêt

*g*
god=dieu
give=donner
grade=catégorie

*h*
hearing=ouie
heart=coeur
huffy=froisse,fache

*i*
igloo=iglou
impish=espiegle
incinerator=incinerateur

*j*
july=juillet
jingo=chauvin
jam=confiture

*k*
key=clef
knife=couteau
kitchen=cuisine

*l*
lagoon=lagune
lash=meche
lapidary=lapidaire

*m*
matrix=matrice
mediator=mediateur
motor=moteur

*n*
never=jamais
nicely=gentiment
numb=engourdi,lourd

*o*
object=objet
odd=bizarre
ornament=ornement

*p*
peace=paix
parting=separation
pastern=paturon

*q*
quay=quai
quiver=carquois
quince=coing

*r*
rank=rang
redefine=redefinir
retreat=retraite

*s*
sawyer=scieur
scree=eboulis
shearing=tonte

*t*
tender=tendre
tilt=inclinaison
tracker=traqueur

*u*
unaware=ignorer
undoubted=indubitable
unlovely=deplaisant

*v*
verso=verso
vilely=vilement
vogue=mode

*w*
waver=vaciller
weakness=faiblesse
weird=surnaturel

*x*
xenon=xenon
xerox=photocopieuse
xenophobia=xenophobie

*y*
yearn=languir
youth=jeunesse
yellow=jaune

*z*
zebu=zebu
zion=sion
zebra=zebre
