*a*

adapter=adapt
affirmation=assertion
ange=angel
ampoule=lamp
avertisseur=horn

*b*

bain=bath
barre=helm
botte=boot
batterie=battery
boulon=bolt

*c*

chien=dog
chat=cat
concierge=caretaker
capot=hood
cendrier=ashtray
compartiment=housing

*d*

decouvrir=discover
desordre=mess
dinde=turkey

*e*

echec=failure
ecole=school
ennui=boredorm

*f*

faux=false
feu=fire
fin=end

*g*

greve=strike
gratuit=free
gros=fat

*h*

histoire=history
horreur=horror
hymne=hymn

*i*

ignorer=ignore
imposteur=impostor
inculper=accuse

*j*

jazz=jazz
javelot=javelin
juge=judge

*k*

kilo=kilo
kart=kart
kaki=khaki

*l*

laine=wool
langue=tongue
laverie=laundry

*m*

main=hand
marcher=walk
mettre=put

*n*

nez=nose
niveau=level
noce=wedding

*o*

ombre=shadow
oreille=hear
ouvrage=work

*p*

pauvre=poor
patience=patience
peine=sorrow

*q*

quartier=district
question=question
quota=quota

*r*

raconter=tell
recherche=search
rongeur=rodent

*s*

sac=bag
sang=blood
servir=serve

*t*

toit=roof
table=table
tonnelle=bower

*u*

urbain=urban
univers=universe
usuel=ordinary

*v*

vache=cow
vautour=vulture
vinaigre=vinegar

*w*

wallon=walloon
wagon=truck
wapiti=wapiti

*x*

xenophobie=xenophobia
xylophone=xylophone
xeres=sherry

*y*

yole=skiff
yourte=yurt
youpi=yippee

*z*

zero=zero
zoo=zoo
zeste=zest
